ahcefhodjjnpmeeaghfhocjiicghdcbn|4thTech Wallet
keenhcnmdmjjhincpilijphpiohdppno|5irechain Wallet
algblmhagnobbnmakepomicmfljlbehg|ADS Wallet
ppdjlkfkedmidmclhakfncpfdmdgmjpm|Aegis Authenticator
iokeahhehimjnekafflcihljlcjccdbe|Alby - Bitcoin
cflgahhmjlmnjbikhakapcfkpbcmllam|Ale
gdokollfhmnbfckbobkdbakhilldkhcj|Alephium Wallet
bkgplkpdgidlgmnlhdfakhcjfpfgjjkb|Ancient8 Wallet
einnioafmpimabjcddiinlhmijaionap|ArConnect Wallet
dlcobpjiigpikoobohmabehhmhfoodbb|Argent X StarkNet Wallet
bhmlbgebokamljgnceonbncdofmmkedg|Atomic Wallet
fhilaheimglignddkjgofkcbgekhenbh|AtomicWallet
cnmamaachppnkjgnildpdmkaakejnhae|Auro Wallet
kilnpioakcdndlodeeceffgjdpojajlo|Aurox Wallet
bhghoamapcdpbohphigoooaddinpkbai|Authenticator
gjffdbjndmcafeoehgdldobgjmlepcal|Authy
caljgklbbfbcjjanaijlacgncafpegll|Avira Password Manager
nbokbjkelpmlgflobbohapifnnenbjlh|BRD
aflkmfhebedbjioipglgcbcmnbpgliof|Backpack
gmcpomojcoaopogcbhpchfpdpfaabihc|BeFi Wallet
ilhaljfiglknggcoegeknjghdgampffk|Beam Web Wallet
papngmkmknnmfhabbckobgfpihpdgplk|BearBy
nhbicdelgedinnbcidconlnfeionhbml|Begin Wallet
fhbohimaelbohpjbbldcngcnapndodjp|BinanceChain
mapbhaebnddapnmifbbkgeedkeplgjmf|Biport Wallet
fihkakfobkmkjojpchpfgcmhfjnmnfpi|BitAppWallet
ijmpgkjfkbfhoebgogflfebnmejmfbml|BitClip
ocmfilhakdbncmojmlbagpkjfbmeinbd|Bitbox
jnldfbidonfeldmalbflbmlebbipcnle|Bitfinity Wallet
jiidiaalihmmhddjgbnbgdfflelocpak|Bitget Wallet (formerly BitKeep)
elalghlhoepcjfaedkcmjolahamlnjcp|Bitgreen Wallet
feejiigddaafeojfddjjlmfkabimkell|Bitski
gkeelndblnomfmjnophbhfhcjbcnemka|Bitverse Wallet (formerly Teleport)
inljaljiffkdgmlndjkdiepghpolcpki|Bitwarden
nngceckbapebfimnlniiiahkandclblb|Bitwarden - Free Password Manager
abogmiocnneedmmepnohnhlijcjpcifd|Blade Wallet
bopcbmipnjdcdfflfgjdgdjejmgpoaab|BlockWallet
aodkkagnadcbobfpggfnjeongemjbjca|BoltX
jnlgamecbpmbajjfhmmmlhejkemejdma|Braavos (StarkNet) Wallet
odbfpeeihdkbihmopkbjmoonfanlbfcl|BraveWallet
jifanbgejlbcmhbbdbnfbfnlmbomjedj|Bread
naepdomgkenhinolocfifgehidddafch|BrowserPass
nlgbhdfgdhgbiamfdfmbikcdghidoadd|Byone
apnehcjmnengpnmccpaibjmhhoadaico|CWallet
kkilomkmpmkbdnfelcpgckmpcaemjcdh|CeloExtensionWallet
dphoaaiomekdhacmfoblfblmncpnbahm|ChromeKeePass
nhnkbkgjikgcigadomkphalanndcapjk|Clover Wallet
aeachknmefphepccionboohckonoeemg|Coin98Wallet
hnfanknocfeofbddgcijnmhnfnkdnaad|Coinbase
blbpgcogcoohhngdjafgpoagcilicpjh|Coinomi
chgfefjpcobfbnpmiokfjjaglahmnded|CommonKey
anokgmphncpekkhclmingpimjmcooifb|Compass Wallet for Sei
ieedgmmkpkbiblijbbldefkomatsuahh|Copay
agoakfejjabomempkjlepdflaleeobhb|Core - Crypto & NFT Wallet
fpkhgmpbidmiogeglndfbkegfdlnajnf|Cosmostation Wallet
jccapkebeeiajkkdemacblkjhhhboiek|Crust Wallet
hifafgmccdpekplomjjkcfgodnhcellj|Crypto.com
dkdedlpgdmmkkfjabffeganieamfklkm|Cyano Wallet
lodccjjbdhfakaekdiahmedfbieldgik|DAppPlay
lmkncnlpeipongihbffpljgehamdebgi|DPal:Wallet for DogeCoin
flikjlpgnpcjdienoojmgliechmmheek|Dashlane
inlfbeejfdgkknpiodhemfcokbdgofja|DeNet
panpgppehdchfphcigocleabcmcgfoca|Desig Wallet
dbhklojmlkgmpihhdooibnmidfpeaing|Digital Bitbox
jiepnaheligkibgcjgjepjfppgbcghmp|Doge Labs Wallet
abamjefkidngfegdjbmffdmbgjgpaobf|Doter Wallet
lgbjhdkjmpgjgcbcdlhkokkckpjmedgc|DualSafe Password Manager
eidlicjlkaiefdbgmdepmmicpbggmhoj|Duo Mobile
ocjdpmoallmgmjbbogfiiaofphbjgchh|ELLI Suit Wallet
hoighigmnhgkkdaenafgnefkcmipfjon|EO.Finance: Crypto & Fiat Wallet
oeljdldpnmdbchonielidgobddffflal|EOS Authenticator
cgeeodpfagjceefieflmdfphplkenlfk|EVER Wallet
agkfnefiabmfpanochlcakggnkdfmmjd|Earth Wallet
bgjogpoidejdemgoochpnkmdjpocgkha|Ecto Wallet
doljkehcfhidippihgakcihcmnknlphh|Edge
ocglkepbibnalbgmbachknglpdipeoio|Edge_Authenticator
hieplnfojfccegoloniefimmbfjdgcgp|Electrum
kkpllkodjeloidieedojogacfhpaihoh|Enkrypt Wallet
kmcfomidfpdkfieipokbalgegidffkal|Enpass Password Manager
blnieiiffboillknjnepogjhkgnoapac|EqualWallet
kmhcihpebfmpgmihbkipmjlmmioameka|Eternl
mcbigmjiafegjnnogedioegffbooigli|Ethos Sui Wallet
idkppnahnmmggbmfkjhiakkbkdpnmnon|Exodus
aholpfdialjgjfhomihkjbmgjidlcdno|Exodus Web3 Wallet
ejehodfgjhiadihgjdkgffciiepfdeep|FINX Wallet
nhlnehondigmgckngjomcpcefcdplmgc|Fearless Wallet
ebfidpplhabeedpnhjnobghokpiioolj|Fewcha Move Wallet
dbgnhckhnppddckangcjbkjnlddbjkna|Fin Wallet For Sei
cjmkndjhnagcfbpiemnkdpomccnjblmj|Finnie Wallet
kglcipoddmbniebnibibkghfijekllbl|Fire
hnhobjmcibchnmglfbldbfabcgaknlkj|Flint Wallet
hpclkefagolihohboafpheddmmgdffjm|Flow Wallet (formerly Lilico)
eokbbaidfgdndnljmffldfgjklpjkdoi|Fluent
mmmjbcfofconkannjonfmjjajpllddbg|Fluvi Wallet
fmblappgoiilbgafhjklehhfifbdocee|Forbole X
agechnindjilpccclelhlbjphbgnobpf|Fractal Wallet
elokfmmmjbadpgdjmgglocapdckdcpkn|FreeOTP
kppfdiipphfccemcignhifpjkapfbihd|Frontier wallet
dldjpboieedgcmpkchcjcbijingjcgok|Fuel Wallet
bifidjkcdpgfnlbcjpdkdcnbiooooblg|Fuelet Wallet
bgpipimickeadkjlklgciifhnalhdjhe|GeroWallet
loinekcabhlmhjjbocijdoimmejangoa|Glass wallet - Sui wallet
ojbcfhjmpigfobfclfflafhblgemeidi|Glow - Solana Wallet BETA
ghpilmjholiicaobfjdkefcogmgaabif|Goblin Wallet
mlbafbjadjidklbhgopoamemfibcpdfi|GoblinWallet
jnkelfanjkeadonecabehalmbgpfodjm|Goby
khcodhlfkpmhibicdjjblnkgimdepgnd|Google Authenticator
gflpckpfdgcagnbdfafmibcmkadnlhpj|GreenAddress
fcglfhcjfpkgdppjbglknafgfffkelnm|Guarda Wallet
hpglfhgfnhbgpjdenjgmdgoeiappafln|GuardaWallet
nanjmdknhkinifnkgdcggcfnhdaammmj|GuildWallet
cnncmdhjacpkmjmkcafchppbnpnhdmon|HAVAH Wallet
nbdpmlhambbdkhkmbfpljckjcmgibalo|Halo Wallet (formerly KuCoin)
fnnegphlobjdpkhecapkijjdkgcjhkib|HarmonyWallet
gjagmgiddbbciopjhllkdnddhcglnemk|Hashpack
jcacnejopjdphbnjgfaaobbfafkihpep|Hive Keychain Wallet
bcopgchhojmggmffilplmbdicgaihlkp|Hycon Lite Client
flpiciilemghbmfalicajoolhkkenfel|ICONex
fghhpjoffbgecjikiipbkpdakfmkbmig|IDriss
ckklhkaabbmdjkahiaaplikpdddkenic|Internet Money - Crypto Wallet
mhonjhhcgphdphdjcdoeodfdliikapmj|Jaxx Liberty
cjelfplplebdjjenllpjcblmjkfcffne|JaxxxLiberty
eegcfalgkkhehkhbjbggbhhlcnckadih|Jellywallet
oohllogfdpaojikdjjkfmklabefnkkfk|Jigstack Wallet
ahidmapichficbkfglbhgmhjcojjmlnm|KEKKAI
hcflpincpppdclinealmandijcmnkbgn|KHC
jblndlipeogpafnldhgmapagcccfchpi|Kaikas
pdadjkfkgcafgbceimcpbkalnfnepbnk|KardiaChain
ionnbdlogiaapopodiglgaakhiifihcl|Kayros Wallet
mmhlniccooihdimnnjhamobppdhaolme|Kee - Password Manager
lbfeahdfdkibininjgejjgpdafeopflb|KeePass
fmhmiaejopepamlcjkncpgpdjichnecm|KeePass Tusk - Password Access
jgnfghanfbjmimbdmnjfofnbcgpkbegj|KeePassHelper Password Manager
kgeohlebpjgcfiidfhhdlnnkhefajmca|KeePassXC
oboonakemofpalcgghocfoadofidjkkk|KeePassXC-Browser
dojmlmceifkfgkgeejemfciibjehhdcl|KeepKey
gofhklgdnbnpcdigdgkgfobhhghjmmkj|Keeper
dmkamcknogkgcdfhhbddcghachkejeap|Keplr
abjfbanhppgiflmobebfffbijcfoeiao|Kontos
mmclamjkknobggpiohfneimmnlggagok|LEDGIS Wallet
gafhhkghbfjjkeiendhlofajokpaflmk|Lace
gabedfkgnbglfbnplfpjddgfnbibkmbb|LastPass
cfoajccjibkjhbdjnpkbananbejpkkjb|LastPass Authenticator
hdokiejnpimakedhajhdlcegeplioahd|LastPass: Free Password Manager
cihmoadaighcejopammfbmddcmdekcje|LeafWallet
fcfcfllfndlomdhbehjjcoimbgofdncg|Leap Cosmos Wallet
aijcbedoijmgnlmjeegjaglmepbmpkpi|Leap Terra
ldinpeekobnhjjdofggfgjlcehhmanlj|Leather
pfkcfdjnlfjcmkjnhcbfhfkkoflnhjln|Ledger Live
hbpfjlflhnmkddbjdchbbifhllgmmhnm|Ledger Wallet
kpfopkelmapcoipemfendmdcghnegimn|LiqualityWallet
fcckkdbjnoikooededlapcalpionmalo|MOBOX WALLET
bmikpgodpkclnkgmnpphehdgcimmided|MYKI
dngmlblcodfobpdpecaadgfbcggfjfnm|MaiarDeFiWallet
enabgbdfcbaehmbigakijjabdpdnimlg|Manta Wallet
efbglgofoippbgcjepnhiblaibcnclgk|Martian Wallet
jkoeaghipilijlahjplgbfiocjhldnap|Mask Network
afbcbjpbpfadlkmhmclhkeeodmamcflc|MathWallet
ejbalbakoplchlghecdalmeeeajnimhm|MetaMask Edge
bkklifkecemccedpkhcebagjpehhabfb|MetaWallet
pfknkoocfefiocadajpngdknmkjgakdg|MetaWallet
nkbihfbeogaeaoehlefnkodbefgpgknn|Metamask
pcndjhkinnkaohffealmlmhaepkpmgkb|Meteor Wallet
nlbmnnijcnlegkjjpcfjclmcfggfefdm|MewCx
bfbdnbpibgndpjfhonkflpkijfapmomn|Microsoft Authenticator
hpbgcgmiemanfelegbndmhieiigkackl|Monsta Wallet
heefohaffomkkkphnlpohglngmbcclhi|Morphis Wallet
ajkifnllfhikkjbjopkhmjoieikeihjb|Moso: Shop and Earn Crypto
nlgnepoeokdfodgjkjiblkadkjbdfmgd|Multi Wallet
pidhddgciaponoajdngciiemcflpnnbg|Mycelium
nknhiehlklippafakaeklbeglecifhad|Nabox Wallet
lpfcbjknijpeeillifnkikgncikgfhdo|NamiWallet
onofpnbbkehpmmoabgpcpmigafmmnjhl|Nash Extension
gjlmehlldlphhljhpnlddaodbjjcchai|Nautilus Wallet
cphhlgmgameodnhkjdmkpanlelnlohao|NeoLine
jbdaocneiiinmjbjlgalhcelgbejmnid|NiftyWallet
fiikommddbeccaoicoejoniammnalkfa|Nightly
kkpllbgjhchghjapjbinnoddmciocphm|Ninji Wallet
njgnlkhcjgmjfnfahdmfkalpjcneebpl|NordPass
admmjipmmciaobhojoghlmleefbicajg|Norton Password Manager
gpnihlnnodeiiaakbikldcihojploeca|NuFi
mcohilncbfahbmgdjkbpemcciiolgcge|OKX Web3 Wallet
ifckdpamphokdglkkdomedpdegcjhjdp|ONTO Wallet
bobfejfdlhnabgglompioclndjejolch|OTP Auth
ppdadbejkmjnefldpcdjhnkpbjkikoip|Oasis Wallet
ilbbpajmiplgpehdikmejfemfklpkmke|OneKey
jnmbobjmhlngoefaiojfljckilhhlhcj|OneKey
coefgobimbelhfmhkpndlddjhkphgnep|OrdinalSafe
icblpoalghoakidcjiheabnkijnklhhe|PIP
mgffkfbidihjpoaomajlbgchddlicgpn|PaliWallet
gadbifgblmedliakbceidegloehmffic|Paragon Wallet
jbkgjmpfammbgejcpedggoefddacbdia|Parallel wallet
jkjgekcefbkpogohigkgooodolhdgcda|Pay with BitPay
ejjladinnckdgjemekebdpeokbikhfci|Petra Wallet
bfnaelmomeimhlpmgjnjophhpkkoljpa|Phantom
cfbfdhimifdmdehjmkdobpcjfefblkjm|Plug
ginchbkmljhldofnbjabmeophlhdldgp|PolkaGate
mopnmbcafieddcagagdcbnhejhlodfdd|Polkadot.js Wallet
jojhfeoedkpkglbfimdfabpdfjaoolaf|Polymesh Wallet
phkbamefinggmakgklpkljjmgibohnba|Pontem Wallet
acmacodkjbdgmoleebolmdjonilkdbch|Rabby
nbdhibgjnjpnkajaghbffjbkcgljfgdi|Ramper Wallet
mjgkpalnahacmhkikiommfiomhjipgjn|Reef Chain Wallet
bmabahhenimmnfijaiccmonalfhpcndh|Relation ONE
hbbgbephgojikajhfbomhlmmollphcad|Rise - Aptos Wallet
hppmchachflomkejbhofobganapojjol|RoboForm
pnlccmojcmeohlpggmfnbbiapkmbliob|RoboForm Password Manager
fnjhmkhhmkbjkkabndcnnogagogbneec|RoninWallet
lgmpcpglpngdoalbgeoldeajfclnhafa|SafePal Wallet
aiaghdjafpiofpainifbgfgjfpclngoh|Safeheron
fcjkomdnccnlklmhncgmaehaakjkddnk|Samara Wallet
apjdnokplgcjkejimjdfjnhmjlbpgkdi|Samourai Wallet
nkddgncdjgjfcddamfgcmfnlhccnimig|SaturnWallet
ammjpmhgckkpcamddpolhchgomcojkle|Scatter
adganlhbinonbpfiehjjpmklkbghkaio|SendWallet
epapihdplajcdnnkdeiahlgigofloibg|Sender Wallet
kbdcddcmgoplfockflacnnefaehaiocb|Shell Wallet
nlobpakggmbcgdbpjpnagmdbdhdhgphk|Shiba Wallet
imeelmcnggkkokgfhinnjhjfilibhpaj|SimpleHold
pocmplpaccanhmnllbbkpgfliimjljgo|Slope Wallet
hfljlochmlccoobkbcgpmkpjagogcgpk|Solana Wallet
bhhhlbepdkbapadjdnnojkbgioiodbic|Solflare Wallet
fhmfendgdocmcbmfikdcogofphimnkno|Sollet
fbeiiganbeffhobegddakpmplljhmfnd|Sparrow Ubiq Wallet
jhfjfclepacoldmjmkmdlmganfaalklb|Splikity
pfdaepphglddodhkmcfoefimbcnkipmn|Spot wallet
mfhbebgoclkghebffdldpobeajmbecfk|StarMask
pgiaagfkgcbnmiiolekcfmljdagdhlcm|Stargazer Wallet
onhogfjeacnfoofkfgppdlbmlmnplgbn|SubWallet - Polkadot
opcgpfmipidbgpenhmajoajpbobppdil|Sui Wallet
khpkpbbcccdmmclmpigdgddabeilkdpd|Suiet - Sui Wallet
fopmedgnkfpebgllppeddmmochcookhc|Suku Wallet
emeeapjkbcbpbpgaagfchmcgglmebnen|Surf Wallet
lnaackabbghipdbjfhdhjempeiopmpop|SwappID
cmndjbecilbocjfkibfbifhngkdmjgog|Swash
nphplpgoakhhjchkkhmiggakijnkhfnd|TON WALLET
eajafomhmkipbjmfmhebemolkcicgfmd|Taho
fijngjgcjhjmmpcmkeiomlglpeiijkld|Talisman - Polkadot Wallet
ookjlbkiijinhpmnjffcofjonbfbgaoc|Temple
aiifbnbfobpmeekipheeijimdpnlpgpp|TerraStation
mnfifefkajgofkcjkemidiaecocnkjeh|TezBox
ckelpdlfgochnkdgikcgbimdcfgpkhgk|Theta Wallet
mfgccjchihfkkindfppnaooecgfneiii|TokenPocket
jpxupxjxheguvfyhfhahqvxvyqthiryh|Trezor
imloifkgjagghnncjkhggdhalmcnfklk|Trezor Password Manager
pnndplcbkakcplkjnolgbkdgjikjednm|Tron Wallet & Explorer
eomhlheglneofffmbfjflldlbcnhpkpb|TronBoss
ibnejdfjmmkpcnlpebklmnkoeoihofec|Tronlink
egjidjbpglichdcondbcbdnbeeppgdph|Trust Wallet
pknlccmneadmjbkollckpblgaaabameg|Trust Wallet
kfdniefadaanbjodldohaedphafoffoh|Typhon Wallet
inlkhilmjmjomfcpdifpfgllhhlpnbej|UniElon
ppbibelpcjmhbdihakflkdcoccbgbkpo|UniSat Wallet
ojggmchlghnjlapmfbnjholfjkiidbch|Venom Wallet
eamiofncoknfkefhlkdblngblpffehek|Verto Wallet
nopnfnlbinpfoihclomelncopjiioain|Viction Wallet
fgkaeeikaoeiiggggbgdcjchmdfmamla|Vtimes
jallplgmgfjfgfhplcnbcpjbpijmgdnc|Wave Wallet
lpilbniiabackdjcionkobglmddfbcjo|Waves Keeper
odaegfdpkolgbdaeibcebmibmibchbce|WaykiMax
lccbohhgfkdikahanoclbdmaolidjdfl|Wigwam Wallet
ghlmndacnhlaekppcllcpcjjjomjkjpg|Wizz Wallet
amkmjjmmflddogmhpjloimipbofnfjih|Wombat
bocpokimicclpaiekenaeelehdjllofo|XDCPay
ocjobpilfplciaddcbafabcegbilnbnb|XPLA Vault Wallet
hmeobnfnfcmdkdcmlblgagmfpfboieaf|XdefiWallet
idnnbdplmphpflfnlkomgpfbpcgelopg|Xverse Wallet
odpnjmimokcmjgojhnhfcnalnegdjmdn|YETI Wallet
ffnbelfdoeiohenkjibnmadjiehjhajb|YoroiWallet
mammpjaaoinfelloncbbpomjcihbkmmc|YubiKey
icpikagpkkbldbfjlbefnmmmcohbjije|Z3US
gbjepgaebckfidagpfeioimheabiohmg|ZEON Wallet
ojbpcbinjmochkhelkflddfnmcceomdi|Zecrey
klghhnkeealcohjjanjjdaeeggmfmlpl|Zerion: Wallet for Web3 & NFTs
klnaejjgbibmhlephnhpmaofohgkpgkd|ZilPay
igkpcodhieompeloncfnbekccinhapdb|Zoho Vault
bofddndhbegljegmpmnlbhcejofmjgbn|eckoWALLET
kncchdigobghenbbaddojjnnaogfppfj|iWallet
jbppfhkifinbpinekbahmdomhlaidhfm|iWallet Pro
gjkdbeaiifkpoencioahhcilildpjhgh|partisia-wallet
